أَبْيَض(بَيْضَاء):أَبْيَض(بَيْضَاء):white:Mastering Arabic Unit 11	أَبْيَض(بَيْضَاء):أَبْيَض(بَيْضَاء):white:Colors
أَحْمَر(حَمْرَاء):أَحْمَر(حَمْرَاء):red:Mastering Arabic Unit 11	أَحْمَر(حَمْرَاء):أَحْمَر(حَمْرَاء):red:Colors
أَخْضَر(خَضْرَاء):أَخْضَر(خَضْرَاء):green:Mastering Arabic Unit 11	أَخْضَر(خَضْرَاء):أَخْضَر(خَضْرَاء):green:Colors
أَزْرَق(زَرْقَاء):أَزْرَق(زَرْقَاء):blue:Mastering Arabic Unit 11	أَزْرَق(زَرْقَاء):أَزْرَق(زَرْقَاء):blue:Colors
أَسْوَد(سَوْدَاء):أَسْوَد(سَوْدَاء):black:Mastering Arabic Unit 11	أَسْوَد(سَوْدَاء):أَسْوَد(سَوْدَاء):black:Colors
أَصْفَر(صَفْراَء):أَصْفَر(صَفْراَء):yellow:Mastering Arabic Unit 11	أَصْفَر(صَفْراَء):أَصْفَر(صَفْراَء):yellow:Colors
أَنْتِ:أَنْتِ/female:you (female):Mastering Arabic Unit 2	أَنْتِ:أَنْتِ/female:you female (2nd f sg):Pronouns
أَنْتَ:أَنْتَ/male:you (male):Mastering Arabic Unit 2	أَنْتَ:أَنْتَ/male:you male (2nd m sg):Pronouns
أَنْتُمْ:أَنْتُمْ:you (plural):Mastering Arabic Unit 9	أَنْتُمْ:أَنْتُمْ:you all males (2nd m pl):Pronouns
الشَّرْق الأَوْسَط:الشَّرْق الأَوْسَط:The Middle East:BCC Words 8	الشَّرْق الأَوْسَط:الشَّرْق الأَوْسَط:The Middle East:Mastering Arabic Unit 9
بارِد:بارِد:cold:BCC Words 6	بارِد:بارِد:cold:Mastering Arabic Unit 12
بَعْدَ ذٰلِكَ:بَعْدَ ذٰلِكَ:after that:Mastering Arabic Unit 12	بَعْدَ ذٰلِكَ:بَعْدَ ذٰلِكَ:after that:Mastering Arabic Unit 13
بَيْض:بَيْض:eggs:BCC Words 9	بَيْض:بَيْض:eggs:Mastering Arabic Unit 12
بَيْنَ:بَيْنَ:between:Mastering Arabic Unit 1	بَيْنَ:بَيْنَ:between:Mastering Arabic Unit 6
حَتَّى:حَتَّى:until:BCC Words 3	حَتَّى:حَتَّى:until:Mastering Arabic Unit 11
خُبْز:خُبْز:bread:BCC Words 6	خُبْز:خُبْز:bread:Mastering Arabic Unit 12
دَجاج:دَجاج:chicken:BCC Words 6	دَجاج:دَجاج:chicken:Mastering Arabic Unit 5	دَجاج:دَجاج:chicken:Mastering Arabic Unit 12
شاي:شاي:tea:BCC Words 3	شاي:شاي:tea:Mastering Arabic Unit 12
صِفْر:صِفْر:zero:Numerals	صِفْر:صِفْر:zero:Mastering Arabic Unit 10	صِفْر:صِفْر:zero:Mastering Arabic Unit 14
عُنْوان:عُنْوان:address, title of book:BCC Words 9	عُنْوان:عُنْوان:address:Mastering Arabic Unit 10
قَبْلَ:قَبْلَ:before, prior to:BCC Words 6	قَبْلَ:قَبْلَ:before:Mastering Arabic Unit 13
قَلَم:قَلَم:pen, pencil:BCC Words 6	قَلَم:قَلَم:pen:Mastering Arabic Unit 5
كُلّ:كُلّ:all/every:Mastering Arabic Unit 11	كُلّ:كُلّ:every/all:Mastering Arabic Unit 16
لا:لا:no:BCC Words 3	لا:لا:no:Mastering Arabic Unit 6
لَوْن(أَلْوان):لَوْن(أَلْوان):color:Mastering Arabic Unit 11	لَوْن(أَلْوان):لَوْن(أَلْوان):color:Colors
مَعَ:مَعَ:with:Mastering Arabic Unit 3	مَعَ:مَعَ:with (prep. for "have"):Mastering Arabic Unit 10	مَعَ:مَعَ:with:Mastering Arabic Unit 13
مَن؟:مَن؟:who?:BCC Words 5	مَن؟:مَن؟:who?:Mastering Arabic Unit 3
نَحْنُ:نَحْنُ:we:Mastering Arabic Unit 4	نَحْنُ:نَحْنُ:we (1st m/f dual/pl):Pronouns
نِصْف:نِصْف:half or middle:Mastering Arabic Unit 10	نِصْف:نِصْف:half:Mastering Arabic Unit 16
نَهْر:نَهْر:river:Mastering Arabic Unit 3	نَهْر:نَهْر:river:Mastering Arabic Unit 6
هُمْ:هُمْ:they (masc.):Mastering Arabic Unit 4	هُمْ:هُمْ:they (males) (3rd m pl):Pronouns
هُوَ:هُوَ:he (and it, masc.):Mastering Arabic Unit 3	هُوَ:هُوَ:he (3rd m sg):Pronouns
هِيَ:هِيَ:she (and it, fem.):Mastering Arabic Unit 3	هِيَ:هِيَ:she (3rd f sg):Pronouns
وَ:وَ:and:BCC Words 1	وَ:وَ:and:Mastering Arabic Unit 2
واحِد:واحِد:one:Numerals	واحِد:واحِد:one:Mastering Arabic Unit 10
يَسار:يَسار:left (vs right):BCC Words 2	يَسار:يَسار:left:Mastering Arabic Unit 7
